%%%%%%%%%%%%%%%%%%%%
%o...%....Y...%....%
%.%%.%.%%%%%%.%.%%.%
%.%............T.%.%
%.%.%%.%%  %%.%%.%.%
%T.....%G  G%......%
%.%.%%.%%%%%%.%%.%.%
%.%...........Y..%.%
%.%%.%.%%%%%%.%.%%.%
%....%...P....%.B.o%
%%%%%%%%%%%%%%%%%%%%
