%%%%%%%%%%%%%%%%%%%%
%o...%....Y...%....%
%.%%.%.%%%%%%.%.%%.%
%.%....S.......T.%.%
%.%.%%.%%  %%.%%.%.%
%T..F..%G  G%......%
%.%.%%.%%%%%%.%%.%.%
%.%...........Y..%.%
%.%%.%.%%%%%%.%.%%.%
%....%...P....%.B.o%
%%%%%%%%%%%%%%%%%%%%
