%%%%%%%%%%%%%%%%%%%%
%.       T   ..%   %
%.%%.%%.%%.%%.%% % %
%        P       % %
%%%%%%%%%%%%%%%%%% %
%.....T            %
%%%%%%%%%%%%%%%%%%%%
