%%%%%%%%%%%%%%%%%%%%%
%.o...%....Y...%.S..%
%..%%.%.%%%%%%.%.%%.%
%..%....S.......T.%.%
%..%.%%.%%  %%.%%.%.%
%.T..F..%G  G%......%
%..%.%%.%%%%%%.%%.%.%
%..%...........Y..%.%
%..%%.%.%%%%%%.%.%%.%
%.....%...P....%.B.o%
%%%%%%%%%%%%%%%%%%%%%
